######################
#                    #
#    #    #    ####  #
#    ######    #@    #
#   #          #######
#                   BD
######################

######################
#                    #
####  ####   #    ####
#        #   ##      #
# ########   ####### #
#@#B            #    #
###D##################

######################
#   @#     #  #      #
#   #      #     #  ##
#  #    #  #  #  #  BD
#  #   #   #     #####
#     #       #      #
######################